0011111111
1000001111
1111001111
1100000111
1100000011
1100000011
1100000011
1111111111
1111111111
1111111111