0010111111
0000100001
1100110011
1000111001
0010100011
0001110111
1100000111
0001100101
1100001001
1000000001