0000000001
1001111001
1001111001
1001111001
1100110011
1110110111
1100000011
1000110001
1100000011
1111001111