0000000000
0001001000
0000110000
0000110000
0001001000
1000000001
0000110000
0000000000
1100000011
1111111111