0111111111
0011111111
0000000000
1001111001
1100000011
1101110111
1100000011
0001111001
1000000001
1111111111