0101001010
0000000000
0000000000
0011001100
0011001100
0000000000
1000110001
1100000011
1100000011
1110110111